34,1,50,35,18,35,34,48
3,49,16,3,2,19,33,50
34,50,19,0,32,35,1,3
3,19,0,49,48,16,33,50
35,49,49,48,32,48,0,50
19,35,50,32,3,1,33,35
33,50,50,33,33,0,0,1
17,33,48,17,19,2,35,33
35,0,32,35,19,33,2,34
